#####################################
#...................................#
#.*...............................*.#
#...................................#
#...................................#
#...................................#
#...................................#
#...................................#
#...................................#
####.............................####
####.............................####
A   .............................   A
####.............................####
####.............................####
#...................................#
#.####.###########.###########.####.#
#.####.###########.###########.####.#
#......##.........S.........##......#
#.#######.##.##.#####.##.##.#######.#
#.#######.##.##.#   #.##.##.#######.#
#.##.........##.#   #.##.........##.#
#.##.####.##.##.#####.##.##.####.##.#
#.##.####.##.##.......##.##.#### ##.#
#*..............##.##..............*#
#####################################