######################################
#....................................#
#....................................#
#....................................#
#....................................#
#....................................#
#....................................#
#....................................#
#....................................#
####..............................####
####..............................####
......................................
####..............................####
####..............................####
#....................................#
#....................................#
#....................................#
#....................................#
#............#########......##.......#
#....####....#########......##.......#
#....#..#.......##..........##.......#
#....####.......##.......#######.....#
#...............##.......#######.....#
#....................................#
######################################