#############
#...........#
#.......##..#
#..ooooo##..#
#..ooooo##..#
#...##......#
#...##......#
#...####....#
#...####....#
#...........#
#############